NO xpm/bookshelf.xpm
SO xpm/bookshelf_01.xpm
WE xpm/bookshelf_02.xpm
EA xpm/bookshelf_03.xpm

F 200,20,200
C 171,154,137


1111111111111111111
1S01001001001001001
10010010010010010011111
10010010010010010000001
10010010000000010011111
1000010000000000001
1000011111111000001
1111000000000001111
1000000101010000001
1111111111111111111

