F 139,99,58
C 171,154,137

NO xpms/monkey.xpm
SO xpms/monkey2.xpm
WE xpms/monkey3.xpm
EA xpms/monkey4.xpm

1111111111
1001001001
1001001001
10010S1001
1001001001
1111111111