NO ./path_to_the_north_texture

WE ./path_to_the_west_texture
EA ./path_to_the_east_texture
SO ./path_to_the_south_texture




F 220,100,0






C 225,30,0

1111111111
111111111111111
1111111111111111
11111111111111111111111
00000000000
11111111111111

1111111111
11111111111111

