111111
111111
111111
101111