11111
11111
11111

11111
10000